#          B
# #########
# #       #
# # ##### #
#   #     #
### # #####
A   #